88888811111111111111888888
11888811111111111111888811
88888888111111111188888888
88888888111111111188888888
11888888881111118888888811
11111188881111118888111111
11111188888811888888111111
88881188888811888888118888 
88881188888888888888118888
11111188888888888888111111
11111188888888888888111111
88888888882222228888888888
88888888882222228888888888
88888888888822888888888888
88881111888822888811118888
88881111888822888811118888
88881111888822888811118888
88881111888888888811118888
88888888888888888888888888
11888888888811888888888811
88888888888811888888888888
11118888888888888888881111
88111111888888888811111188
88881111882222228811118888
88888811882222228811888888
88888811882222228811888888