22220000000000000000002222
22220000000111100000002222
00000011000000000011000000
00000000000000000000000000
00110000002222220000001100
00110000000000000000001100
00000000000000000000000000
00000000002222220000000000
00000000000000000000000000
00001100000000000000110000
00001111000000000011110000
00000000000000000000000000
00000000000000000000000000
00000022220000002222000000
11000022220000002222000011
00000000000000000000000000
00000000000011000000000000
00111100000000000000111100
00000000000000000000000000
00000000333333333300000000
00880033300000000333008800
33883333000000000033338833
00880000000111100000008800
00000000001100110000000000
00001000000000000000100000
00111000000000000000111000