22444444444444444444444422
22444444444444444444444422
44444444222222222244444444
44444444222222222244444444
44222244222222222244222244
44444444222222222244444444
44444444444444444444444444
44444444444444444444444444
44442222224444442222224444
44442222224444442222224444
44444444444444444444444444
44444444444444444444444444
44444444442222224444444444
44444444442222224444444444
44444444442222224444444444
22224444444444444444442222
22224444444444444444442222
44444444444422444444444444
44444444444444444444444444
44442222444444444422224444
44442222444444444422224444
44442222444444444422224444
44442222444444444422224444
44442222444444444422224444
44444444444222244444444444
44444444444222244444444444