00000033333333333333000000
00000088888888888888000000
00020088888888888888002000
00020033333333333333002000
00000033333333333333000000
00000033333333333333000000
11883333333111133333338811
33883333333111133333338833
33883333333333333333338833
33888880000011000008888833
33888880000011000008888833
33333330000000000003333333
33333330020000002003333333
33333330020088002003333333
33111133333388333333111133
33333333333388333333333333
33333333333188133333333333
33313333333000033333331333
00023331333188133313332000
00023331333388333313332000
00003331333388333313330000
00003333888888888833330000
00000333888888888833300000
00000000883333338800000000
00200000883333338800000200
00200003333311333300000200